22 20
11111111111111111111
11000100010001000101
10010001000100010001
10111011101110111011
10010001000100010001
11000100010001000101
11101110111011101111
11000100010001000101
10010001000100010001
10111011101110111011
10010001000100010001
11000100010001000101
11101110111011101111
11000100010001000101
10010001000100010001
10111011101110111011
10010001000100010001
11000100010001000101
11101110111011101111
11000100010001000101
10010001000100010001
11111111111111111111
1 2
20 18
1 18
20 1
