22 20
11111111111111111111
10100000000000000001
10111001110110001101
10001100100011111001
10100110011010000001
10110011001110111001
10101001100100010001
10100000110011111101
10111110011000010001
10000011001011111101
10111001111010000001
10001010000000111101
10100000111110000101
10110110100100111101
10100100100000000101
10110110110111110001
10010000010100011001
10011011111100001101
10110000000000100101
10011010101111111101
10001010100000000001
11111111111111111111
1 2
20 18
1 18
20 1
