22 20
11111111111111111111
10000000000000000001
10111111111111111101
10101000000000000001
10100010111111111101
10111010000000000101
10101011101111110101
10101000101000010101
10101110101011010101
10100010101011110101
10101110101000000101
10101011101111111101
10101000001000000101
10101011111111110101
10100010000000000101
10101111111111110101
10101000000000010101
10101011111101110101
10000000000000000101
10111111111101111101
10000000000000000001
11111111111111111111
1 1
20 18
1 18
20 1
